11111111111111111111
1P001110000000000011
10000000000001100011
1000C0E0000000000011
10000000010100000001
10000010000000001001
11111111111111111111
