11111111111111111111
1P001110000000000001
10000000000011100001
1000C0E0000010000001
10000000011100000001
10000010000000001001
11111111111111111111
