11111111111111111111
10000000000000000001
10000000000000000001
1000H0E000100000C001
10000000000000000001
1P000000000C00000001
11111111111111111111