11111111111111111111
10000000000000000001
10000000000000000001
1000C0E0001000000001
10000000000000000001
1P000000000000000001
11111111111111111111
