11111111111111111111111111
1C10000000000H000000000001
1C0111111110C1111111111C01
10000000000000000C00000001
100C0000000000000000000001
10011111111001000000000C01
100C0000000000001111111001
1001111111100001C010000C01
10000H000000001C000HC00001
10C00101010000100110111001
100001CH0100001P00000000E1
11111111111111111111111111