1111111111111111111111111111111111
1E0000000000000C00000C00000000H001
101001010010000010100100H000010101
1010010010101010001001000000010101
1P00H0000C00C0000000000000000000C1
1111111111111111111111111111111111