11111111111111111111111111
1E000000000000000000000001
10011111111001111111111001
10000000000000000C00000001
10011111111001111111111001
10000000000000000000000001
10011111111001111111111001
10000000000000000000000001
10011111111000000111111001
10000000000000000000000001
10011111111000000111111001
100000000000000P0000000001
11111111111111111111111111
