11111111111111111111111111
1E000000000000000000000001
100111111110C1111111111C01
10000000000000000C00000001
10011111111001111111111001
100C0000000000000000000001
10011111111001111111111C01
100C0000000000000000000001
1001111111100000C111111C01
10000000000000000000000001
10C1111111100000C111111001
100000000000000P0000000001
11111111111111111111111111
