111111111111111111111111111111111111111111111111111111111111
1P0000000000000111100001111111000000000011100000000000000001
100000000000000001100001000111000000000011000000000000000001
100000000000000000100000000000000000000011100000000000000001
110000000000000000000000000000000000000000000000000000000001
110000000000000001111100000000000000000000000000000000000001
11000000000000000001110000000000C000000000000000001111100001
110000000000000000000100000000000000000000000000000000000001
100000000000000000000100000000000000000000000000000000000001
100000000000000000000100000000000000000000000000000000000001
100000000000000000000000000000000000000111111110000000000001
100000000000000000000000000000000000000000000010000000000E01
100000111000000000000000000000000000000000000010000000000001
111111111111111111111111111111111111111111111111111111111111
