111111111111111111111
100E00000000000000001
100000000C00000000001
100000000000000000001
100000000000000000001
100000000000000000001
100000000000000000001
111111111111111111111
