111111111111
1000001
1000001
1111111
